>s1
---------------------------------------------------------------------------------------------------------------------------------------------------CGCA-T-T-----TCTGG---TC--C----T-CACATAGACTCAGAAAGAACCCACCATGGTGCTGTC-TC-CCGC---CGACAA-GACCAACGTCAA--G-A-C--CACCT-GGGATAAGCTTGG-TGGCCAC-GCTG-GC-GAGTATGGCG--GAGAGGCTCTGGAGAGGTGAGG-A-C-C--------CAACCT-TCC-CCG----G---------TTGGG--------------------ATCAGGGC-TC--G---------G-GGAC-CC---C--TCG-CG-------------GC-CCTTG--T--C---GTCCAC-CG----C-CCCACCTAACCCCGGCT---CGCCC--AC-CCCT-TCCTC-CCGCAGGACCTTCAC-GTCCTTC-CCCACC-ACCAAGACCTACTTC-CCCCAC-TTCGACCTG---AGCCCCGGCTCCGCCCAGGTCAA-GG-CTCACGGCAAGAAGGTGGCCGACGC-GC--TGACC-----A-CCGCTGTGGCCCA-CATAGA-TGAC--CTG-CCAGGCGC-CCTGT-C-GGCTCTGAGCGACCTGCACGCGT-ACAAGCTGCGTGTGGACCCTGTCAACTT-CAA-G-GT--G---A--------GC--AC-G------C--GG----G-------C---------C-G--G---C---CCG------GAGA------G--A---T-----------CTGGGGC---AG--GAGGGTGCAGCGGGGCC-TGCTAGCAGG---------GC---------G-GAC-----------GGC--C---C----CCGGGTTCCGGCAGGTGGAGCGCGGGTG-GCCGCT-GA-CGTC----CC-CTC-T-CT---CC--GCA-G----C--TCCT--GAGCC-A--CTGCCTG-C-TGGTGA----CCCTGG---CC-T--GCCACC-AC----CC-C--GCG-GAATTC-A--C----CCC-----TGCGGT-CCA-CG----CC-T----CCCTGGACAAGTTCTTCAGCGC--CGTGAGC-ACCGTGCTGACCTCCAAATACCGTTAA-G-CTGAAGC-CGC---GGC--G--GTCCCCCTGTCC-C--CGGCC----CGG----GGC-TCTCC-TGCGC-T-CGGC-GC-A---C--CT-C-AACTTCC-----CG-ATCTT-TG-AATAAAGTCTG-AG--TGGGCTGCAGCCTCT
>s2
-------------------------------------------------------------------------------------------A--TAA--A----AG-C---T-C--GC--G----CAC-TCG-C-AG------CCC-CGCACTCT-----TCTGG---TC--C-AG----ACCCAGACTCTGAGAGAACCCACCATGGTGCTGTC-TG-CCGC---CGACAA-GGGCAATGTCAAG-G---C--CGCCTGGGGC-AAGGTTGG-CGGCCAC-GCT--GCAGAGTATGGCGC--AGAGGCCCTGGAGAGGTGAGC-A-C-C-------GC-ACTT-GCC-CCG---AG-----------GGG--------------------A-CCGGGC--C--G-----------C-ACGCCGGGC----GT-G-------------TC--CTTG--TCCCGG-G-C--C--G----CTC-GGCCTAAGCCCGGCT---TTCCC--G--C-C--TCTTCACC-CAGGATGTTC-CTGAGCTTC-CCCACC-ACCAAGACCTACTTC-CCCCAC-TTCGACCTG---AGCCACGGCTCCGCGCAGGTCAAGGG-C-CACGGCGCGAAGGTGGCCGCCGC-GC--TGACC---AAAG-CG--GTGGAACA-CCTGGA-CGAC--CTG-CCCGGTGC-CCTGT-C-TGAACTGAGTGACCTGCACGC-TCACAAGCTGCGTGTGGACCCGGTCAACTT-CAA-G-GT--G---A--------GC--TC-G------C--GG----G-------C---------AGG--G---C---CGG------GACA------G--A---T-----------CT-GGGCT--AG---CGGG-GCA--GAG-AA-TGC-----GG----------C---------G-G-C------------GC--C---C------------C--CA--CCCAGCCCC-C-GCCCCCCT-GA-CGTC----CC-CTC-T-CT---CG--GCA-G----CT-TC-T--GAGCC-A--CTCCCTG-C-TGGTGA----CCCTGG---CC-TC--CCACC-TC----CC-CAG-TG--ATTTC-A--C----CCC-----CGCGGT-CCA-CG----CC-T----CCCTGGACAAGTTCTT-GGC-CAACGTGAGC-ACCGTGCTGACCTCCAAATACCGTTAA-G-CTGGAGC-CTC---GGC--GA----CCCCT-ACC-C-T-GGCCT----GG----AGC-CC-CCTTGCGC-T-CTGC-GC-A---C-TCT-C-A-CCTCC-----TG-ATCTT-TG-AATAAAGTCTG-AG--TGGGCTGCA------
>s3
----------------------------------------------------------------------------------------------------------------------------------------------------G--------------GG------GC----TGC-C--A-ACACAG--AGGTGCAACCATGGTGCTGTC--CGCTGC---TGACAA-GAACAACGTCAAGGGCATCTTCACC-----A-AA--ATCGCCGGCCA-TGCTGAG--GAGTATGGCGCCGAGA--CCCTGGAAAGGT-AGGTGTC-C------TTC--TCTGTCCTCCG----G---------CT--G-------CCTCTCTCCCCTGATC--CTCTTCCCG---TCCTCAGCTG-C-CC--AC-GTC--C----------TATCCCTCCCTGCCTTAC-CCGTCC-CTC----TC-CCCTCCT--GCCCTGCT---AGCCCTGACTCACTGTGCT--CCACAGGATGTTCAC-CACCTAC-CCC-CCAACCAAGACCTACTTC-CCCCAC-TTCGATCTG-TCA--CACGGCTCCGCTCAGATCAA-GG-GGCACGGCAAGAAGGTAG-TG--GCTGCCTTGATC----GA--GGCTGCCAACCA-CATTGA-TGACATC-G-CC-GGCAC-CCTCTCCAAGCTC--AGCGACCTCCATGC-CCACAAGCTCCGCGTGGACCCTGTCAACTT-CAA--AGT--G---A--------G-----TG-----TC-TGG----G-----------------AAG--G---------G------GTGA---CCCG----------------CCCT---GC----CCCCA--CCGCAGC---CCCGT-CT---TGG---------GC--------CATG-C-----------GGC--C--AC----CC---CT-C-GC--CT-CA-C-C-------CC-CTCG--C-TC--ATCCTCTCCT--TTTGCCTTGCA-G----C--TCCT--GGGCCAATGCTTCCTG--GTGGTG-------GTGG---CCAT---CCACC-A-----CC-C-TGC-TGCCCT-GA--C----CCC-----GGAGGT-CCA-TG-----C-T---TCCCTGGACAAGTTCTTGTGCGC--CGTGGGC-ACTGTGCTGACCGCCAAGTACCGTTAA-GAC-G--GCACG--GTGGCTAG-AG-----CTG-------GGGCC--AAC-------CCATCGCC-AGC-CCTCCGACAGCGA--GCAGC--C-AA-AT--------G-A---GATGAAATAAAATCTGTTGCATTTG-TGC-TCC-AG
>s4
----------------------------------------------------A-----C-----T-----------------CT-------------T----------CT------G-GT----CC---C--C--A-C----A---------------------G-A-----C---T------CAG----AA--AGAACCCACCATGGTGCTGTC-TC-CTGC---CGACAA-GACCAACGTCAAG-G-C----CGCCTGG-GGTAAGGTCGG-CGCGCAC-GCTG-GC-GAGTATGGTGC-G-GAGGCCCTGGAGAGGTGAG---GCTC-----------CCT-CCC-CTG-----C------T---CCGAC-CCGGGCTCC----------TC-GCC--CG-CC----------CTGACCCA-CAGG----C-CA---C----CC-TCAGC-GG--TCCTGGC-CC--C-GG--CCC-CAAACCCCA--CC-CCT-CACTC-T--GC-TTC--TCC-C-CG-CAGGATGTTC-CTGTCCTTC-CCCACC-ACCAAGACCTACTTC-CCCCAC-TTCGACCTG--AGC-CACGGCTCTGCCCAGGTTAAGGGC--CACGGCAAGAAGGTGGCCGACGC-GC--TGACC-A--ACGCCGTGGC-G--CA-CGTGGA-CGAC--ATGCC-CAACGCGC-TGT-C-CGCCCTGAGCGACCTGCACGC-GCACAAGCTTCGGGTGGACCCGGTCAACTT-CAA-G-GT--G---AG---C-G-GC---GGG-----CC-GGGA---GC------GAT--C--T--GG--GT--CGAGGGG--C-----GA------G--A---TG--G--CG--CCT--TCCTC--G---CAGG-GCA--GAGGAT-CAC-G-CGAGT----TGC-G-GGA-GGTG-TAG-C--------GCAGGCGGC-GGCTG---CGGGC--CT-----G--GG--CT-----C-CACT-GAC--CCT---CT--TC-T-CTG--C---ACA-G----CT-CC-T--AAGCC-A--CTGCCTG-C-TGGTGAC---C-CTGGC---C-GC--CCACC-TC----CC-C-GCCGA-GTT-C-A--C----CCC--TG-C--GGTG-CAC-G----CC-T----CCCTGGACAAGTTCCT-GGC-TTCTGTGAGC-ACCGTGCTGACCTCCAAATACCGTTAA-G-CTGGAGC-CTCGGTGGC--CAT-GCTTCTTGCCC-CTTGGGCCTCTC-G-CCAGGCC-C-TCCTCT-CCTT-CC-T-GC-ACCT-GTAC-C--CC--CCCTG---G--TCTT-TG-AATAAAGTCTG-AG--TGGGCGGC-------
>s5
----------------------------------------------------A-----C-----T-----------------CT-------------T----------CT------G-GT----CC---C--C--A-C----A---------------------G-A-----C---T------CAG----AG--AGAACCCACCATGGTGCTGTC-TC-CTGC---CGACAA-GACCAACGTCAAG-G-C----CGCCTGG-GGTAAGGTCGG-CGCGCAC-GCTG-GC-GAGTATGGTGC-G-GAGGCCCTGGAGAGGTGAG---GCTC-----------CCT-CCC-CTG-----C------T---CCGAC-CCGGGCTCC----------TC-GCC--CG-CC----------CGGACCCA-CAGG----C-CA---C----CC-TCAAC-CG--TCCTGGC-CC--C-GG--ACC-CAAACCCCA--CC-CCT-CACTC-T--GC-TTC--TCC-C-CG-CAGGATGTTC-CTGTCCTTC-CCCACC-ACCAAGACCTACTTC-CCGCAC-TTCGACCTG--AGC-CACGGCTCTGCCCAGGTTAAGGGC--CACGGCAAGAAGGTGGCCGACGC-GC--TGACC-A--ACGCCGTGGC-G--CA-CGTGGA-CGAC--ATGCC-CAACGCGC-TGT-C-CGCCCTGAGCGACCTGCACGC-GCACAAGCTTCGGGTGGACCCGGTCAACTT-CAA-G-GT--G---AG---C-G-GC---GGG-----CC-GGGA---GC------GAT--C--T--GG--GT--CGAGGGG--C-----GA------G--A---TG--G--CG--CCT--TCCTC--G---CAGG-GCA--GAGGAT-CAC-G-CGGGT----TGC-G-GGA-GGTG-TAG-C--------GCAGGCGGC-GGCTG---CGGGC--CT-----G--GGCCCTC-GGCCCCACT-GAC--CCT---CT--TC-T-CTG--C---ACA-G----CT-CC-T--AAGCC-A--CTGCCTG-C-TGGTGAC---C-CTGGC---C-GC--CCACC-TC----CC-C-GCCGA-GTT-C-A--C----CCC--TG-C--GGTG-CAC-G----CC-T----CCCTGGACAAGTTCCT-GGC-TTCTGTGAGC-ACCGTGCTGACCTCCAAATACCGTTAA-G-CTGGAGC-CTCGGTGGC--CAT-GCTTCTTGCCC-CTTGGGCCTC-C-CCCCA-GCC-CCTCCTC-CCCTT-CC-T-GC-ACC-CGTA--C--CC--CCGTG---G--TCTT-TG-AATAAAGTCTG-AG--TGGGCGGCA------
>s6
--------------------------------------------------------CCC--C--T------CGCG-CC----C-CAG-G-CA--TAA--A--G--G-C---T-C--GC--G----CAC-T-CCC-AG------CCCT-GCACGCT-----TCTGG---TC--CT-G----ACCCAGACTCAGAGAGAACCCACCATGGTGCTGTC-TC-CCGC---CGACAA-GACCAACGTCAAG-G---G--CACCTGG-TCTAAGATTGG-CAACCACAG-T--GCAGAATATGGCGC--AGAGGCCCTGGAGAGGTGAGC-AGC-C--------C-ACCT-GCC-C-G----GC------T---GGGA----------C----------TGGGGC--CG-G---------T-C---GCC--CC----GTCGCA-----------TC--CTGG--TCCTGG-G-C--C--G--A-C-C-AGCCTAAGCCCGGCT---CTCCC--GT-CTCT-TCTCCACT-CAGGATGTTC-ATAAACTTC-CCCAGC-ACCAAGACCTACTTC-TCCCAC-TTCGACCTG---GGACACGGCTCCGCCCAGATCAAGGG-G-CACGGCAAGAAGGTGGCCGACGC-GC--TCACC---AAAGCCGT-G-GGC-CA-CATAGA-CAAC--CTG-CCCGATGC-CTTGT-C-TGAGCTGAGCGACCTGCACGC-CCACAAGCTGCGTGTGGACCCGGTCAACTT-CAA-G-GT--G---A--------GC--TC-G------C--GG----GC------C----------GG--GT--C----GG------AAGA------G--A---T-----------CT-GAGCT--AG---CAAG-GCA--GAG-AG-TGCGGTGGGGT----T-C--CAGA-GGTG-GAG-C--------AC-GGCGGC--ACT-----------C--C---CCCAACCCCGCGG-CCC-CT-GA-CACC----CC-CTC-T-CT---CC--GCA-G----CT-CC-T--GAGCC-A--CTGCCTG-C-TGGTGA----CCCTGG----C-TC-TCCACC-TC----CC-C-GCCG--ATTTC-A--C---GCCC--T--C--GGT-CCA-TG----CC-T----CCCTGGACAAGTTCTT-GGC-CAGTGTGAGC-ACCGTGCTGACCTCCAAATACCGTTAA-G-CTGGAGC-CTC---CGC--GA--T--TCCT-ACC-C-T-GGCCT----GG----GGC-CCT-CTGGCGC-T-CTGG-GC-A-C-C--CT-C-A-CTTCC-----CG-ATCTT-TG-AATAAAGTCTG-AG--TGGGCTGCA------
>s7
----------------------------------------------------A-----CA----T--------------------------------T----------CT--------------CCTT-C-TT--A-T----A---------------------G-A-----C---T------CAG---------GAAGCAATCATGGTGC--TC-T--CTGCAGATGACAA-AACCAACATCAAGAA-C----TG-CTGG-GGGAAGATTGGTGGC-CAT-GGTG-GT-GAATATGGCGA-G-GAGGCCCTACAGAGGTGA----GATCA-G----G-------ACC-CTGTT---C--TT--T--AAGGACAGCAGGATCCAA---A-----C---C--GGACC-------AG--GGACTCAGTGGG------CA-G-C---TCC-TAAG--TG--TGCTTTC-CCG-T-GG--CCT-C-AA-CTTAT--C---T-CTC-C-------TTC--T---C--A-CAGGATGTTCGCTG-CCTTC-CCCACC-ACCAAGACCTACTTCT-CTCACATT-GA--TGTAAGC-CCCGGCTCTGCCCAGGTCAA-GGCT-CACGGCAAGAAGGTTGCTGATGC--CT-TGGCCAA--A-G-C-T-GCAGACCA-CGTCGA-AGAC--CTGCCTGG-TGCCC-TGT-C-CACTCTGAGCGACCTGCATGC-CCACAAACTGCGTGTGGATCCTGTCAACTT-CAAGGTGTGAGCTCAGAC-CTG-GCAGGGGGCA---CCTGGGACCTCCAA---GGATCCCT-TGGGGCAGTGGTGAGGGGCACAGAGGGAGG--GGGA-A--G-G--G---G----T--TCCTCATGC-CCAGG-GCA--G-GGAA-CACAG---TGT----TCCAG-GAA-GG-G-GAG-C-----T---TACCCAGCAGGGTG--TCTA-CTACT-A---G--GGA-CTG---AC-C-CT-T-C--C-T---GT---CTT--TG--C-----A-G--T--T-CC-TG-A-GCC-A--CTGCCTG-C-TGGTGAC---C-TTGGC--TT-GC---CACCA-C----CCTG-G-AGAT-TT-C-A--CA---CCC---GCCA---TG-CAC-G----CC-T----CTCTGGACAAATTCCT-TGC-CTCTGTGAGC-ACTGTGCTGACCTCCAAGTACCGTTAA-G-C--C-G--C-C--T--C--C-T-GC--C--G-GG-CTT--GCCT-TCTGACCAGGCC-CTT-CT-TCCCTC-CCTT-GC-ACCT-ATAC----CT--CT-TG---G--TCTT-TG-AATAAAGCCTG-AG--TAGGAAGC-------
>s8
--------------------------------------------------------CCC--C--T------CGCG-CC----C-CAG-G-CA--TAA--A--G--G-C---T-C--GC--G----CAC-T-GCC-AG------CCCT-GCACGCT-----TCTGG---TC--CT-G----ACCCAGACTCAGAGAGAACCCACCATGGTGCTGTC-TC-CCGC---CGACAA-GACCAACGTCAAG-G---G--CACCTGG-TCTAAGATTGG-CAACCACAG-T--GCAGAATATGGCGC--AGAGGCCCTGGAGAGGTGAGC-AGC-C--------C-ACCT-GCC-C-G----GC------T---GGGA-------------------A-TGGGGC--CG-G---------T-C---GCC--CC----GTCGCA-----------TC--CTGG--TCCTGG-G-C--C--G--A-C-C-GGCCTAAGCCC-GCT---CTCCC--GT-CTCT-TCTCCACT-CAGGATGTTC-ATAAACTTC-CCCAGC-ACCAAGACCTACTTC-TCCCAC-TTCGACCTG---GGACACGGCTCCGCCCAGATCAAGGG-G-CACGGCAAGAAGGTGGCCGACGC-GC--TCACC---AAAGCCGT-G-GGC-CA-CATAGA-CAAC--CTG-CCCGATGC-CTTGT-C-TGAGCTGAGCGACCTGCACGC-CCACAAGCTGCGTGTGGACCCGGTCAACTT-CAA-G-GT--G---A--------GC--TC-G------C--GG----GC------C----------GG--GT--C----GG------GAGA------G--A---T-----------CT-GAGCT--AG---CAAG-GCA--GAG-AG-TGCGGTGGGGT----T-C--CAGA-GGTG-GAG-C--------A-TGGCGGC--ACT-----------C--C---CCCAACCCCGCAG-CCC-CT-GA-CACC----CC-CTC-T-CT---CC--GCA-G----CT-CC-T--GAGCC-A--CTGCCTG-C-TGGTGA----CCCTGG----C-TC-TCCACC-TC----CC-C-GCCG--ATTTC-A--C---GCCC--T--C--GGT-CCA-TG----CC-T----CCCTGGACAAGTTCTT-GGC-CAGTGTGAGC-ACCGTGCTGACCTCCAAATACCGTTAA-G-CTGGAGC-CTC---CGC--GA--T--TCCT-ACC-C-T-GGCCT----GG----GGC-CCT-CTGGCGC-T-CTGG-GC-A-C-C--CT-C-A-CTTCC-----CG-ATCTT-TG-AATAAAGTCTG-AG--TGGGCTGCA------
>s9
TGGCCCCCGCCCCGTGTGCGCCCCCAGCGGAGGCCAAGCCGCCCTGTCCGGGACTCCCCTGCGGTCCAGGCCGCGCCCCGGGCTCCGCGCCAGCCAATGAGCACCGCCCTG-CCGGGCGTGCCCCCGCGC-CCGGAGCATAAACCCTGGCGCGCTGGCTGCCCGGCACTCTTCTGGTC-CCCACAGACTCAGAAAGAACCCACCATGGTGCTGTC-TC-CTGC---CGACAA-GAGCAACGTCAAG-G-C----CGCCTGG-GGTAAGGTCGG-CGGGCAC-GCTG-GC-GAGTATGGTGC-G-GAGGCCCTGGAGAGGTGAG---GCTC-----------CCT-CCC-CTG-----C------T---CCGAC-CCGGGCTCC----------TC-GCC--CG-GC-------TT-C--ACCCA-CCGG----C-CA---C----CC-GCAAC-CG--TCCTGGC-CC--C-GG--ACC-CAAACCCCA--CC-CCT-CACTC-T--GC-TTC--TCC-C-CG-CAGGATGTTC-CTGTCCTTC-CCCACC-ACCAAGACCTACTTC-CC-CAC-TTCGACCTG--AGC-CACGGCTCTGCCCAGGTTAAGGGC--CACGGCAAGAAGGTGGCCGACGC-GC--TGACC---CTCGCCGTGG--G-GCA-CGTGGA-CGAC--ATGCCCCAA-GCGC-TGT-C-CGCGCTGAGCGACCTGCACGC-GCACAAGCTTCGGGTGGACCCGGTCAACTT-CAA-G-GT--G---AG---C-G-GC---GGG-----CC-GGGA---GC------GAT--C--T--GG--GT--CGAGGGG--C-----GA------G--A---TG--G--CG--CCT--TCCTC--G---CAGG-GCA--GAGCAT-C-CCG-CGGGT----TGC-G-GGA-GGTG-CAG-C--------GCAGGCGGC-GGCT-------G---C------G--GGCCCTC-GGCCCCACT-GAC--CCT---CT--TC-T-CTG--C---ACA-G----CT-CC-T--GAGCC-A--CTGCCTG-C-TGGTGA----CTCTGGC---C-GC--TCACC-TC----CC-C-GCCGA-GTT-C-A--C----CCC--TG-C--GGTG-CAC-G----CC-T----CCCTGGACAAGTTCCT-GGC-TTCTGTGAGC-ACCGTGCTGACCTCCAAATACCGTTAA-G-CTGGAGC-CTCGGTGGC--CAT-GCTTCTTGCCC-CTTGGGCCTC-C-CGCCA-GGC-CCTCCTC-CCC-T-CCTT-GC-A-C-CG---GC--CCTTCC-TG---G--TCTT-TG-AATAAAGTCTG-AG--TGGGCGGCA------
>s10
----------------------------------------------------AG----CATC--T-----------------GG-------------T----------GT------G-G-----ACTG-C-TT--A-T----T---------------------GCA-----CA--A------CA----------CAAACAA-CA--ATGCA-TCTTA-CAGCTGATGACAAGAAAC-ACATCAAGGC-C-A--T--TTGGCCTTCTG-TAGCT-GCTCAT-GGTG-AC-AAATATGGCG--GAGAAGCTTTGCACAGGT-A----AATTATGCTCTGA-ATTA-ATG-CTGTTAACCAATTGCTAAAATGA-ATTAGGAT-AAATTTATTG-TCAGAT--GGTCCTTAATAAAG-TTG-CTGAATGGGTTAAA-CATGCCATTTCCTTAAA--AG---G--TGC-CTGAT-GGATATT-A-AA-ATTATCCC-TTTACTCTCAT--TT-TTT--T---C-AA-CAGGATGTTC-ATG-TGTGCTCCCAAG-ACCAAAACCTACTT-TCCTGATTTT-GAC-T-TCAGCGAAC-ATTCAAAACACATCTT-GGCT-CATGGCAAGAAAGTTTCGGATG---CTCT-G--AATGAGG-CTT-GCA-ACCATC-TGGACA-ACA-TTGCC-GGATG-CC-TGT-C-CAAGCTGAGTGACCTCCATGC-CTATGACCTGAGAGTGGATCCAGGCAACTTCCCA-GTAAGTGCTTTG-CAATGTGTATTATAAATTTTCT-ATATTTCTAATTTTTATATATATTTGG-AGT-GTAAATAATATATA-AAAGGTATATATACTGCGTAGACTGTTTTT-GTTTTTAT-CTTTA-T-GTA--T-TTAA-TA-AG-A-TATCAAGTCCAGCTAATTA-A-GAG-CTTATGTAAATACCC-CCAAAATGACTCTATGTCCT-----GTTTAATTTG-AAACACTCTATACTACTTAACTT-AACTTAATGACCT--TTATGCTTGCTACCATGCACACCTATTCTGATTGTCTTTCTTTCTTTCTTTTGCAGTT-GCTGGC-CCATCAAATTCTG-GTGGTTGTTGCTATCCATTTCCCTAAG-CAGTTTGACCCTGCAACCCATAAGGCCCTGGACAAGTTCCT-GGT-TTCCGT-ATCTAATGTTCTGACATCCAAATATCGTTAAGG-CT-CAG--CAG--TAACA-G-TAGC--A--GAAG-TTTG-GACA-TCAGA-CA-TCA-GTTAAT-GACAAA-CAAT--CAAACTGACACAG--CT---TGTGAAAGAATGTTCTGAAATAAA-CATT-TT--TA-AAATT-------
>s11
---------------------------------------------------------------------------------------------------------------------------------------------------CGCACTCT-----TCTGG---TC--C-AG----ACCCAGACTCAGAGAGAACCCACCATGGTGCTGTC-TG-CCGC---CGACAA-AAGCAATGTCAAG-G---C--CGCCTGGGGC-AAGGTTGG-CGGCCAC-GCT--GCAGATTATGGCGC--AGAGGCCCTGGAGAGGTGAGC-A-C-C-------GC-ACCT-GCC-CCG---AG-----------GGG--------------------A-CCGGGC--C--G-----------C-ACGCCGGGC----G-CG-------------TC--CTTG--TCCCGG-G-C--C--G----CTC-GGCCTAAGCCCGACT---TTCCC--G--C-C--TCTTCACC-CAGGATGTTC-CTGAGCTTC-CCCACC-ACCAAGACCTACTTC-CCCCAC-TTCGACCTG---AGCCACGGCTCCGCCCAGGTCAAGGG-C-CACGGCGCGAAGGTGGCCAACGC-GC--TGACC---AAAG-CG--GTGGGCCA-CCTGGA-CGAC--CTG-CCCGGTGC-CCTGT-C-TGAACTGAGTGACCTGCACGC-TCACAAGCTGCGTGTGGACCCGGTCAACTT-CAA-G-GT--G---A--------GC--TC-G------C--GG----G-------C---------CGG--G---C---CGG------GACA------G--A---T-----------CT-GGGCT--AG---CGGG-GCA--GAG-AA-TGC-----GG----------C---------G-G-C------------GC--C---C------------C--CA--CCCAGCCCC-C-GCCCCCCT-GA-CGTC----CC-CTC-T-CT---CG--GCA-G----CT-TC-T--GAGCC-A--CTCCCTG-C-TGGTGA----CCCTGG---CC-TC--CCACC-TC----CC-CA-ATG--ATTTC-A--C----CCC-----CGCGGT-CCA-CG----CC-T----CCCTGGACAAGTTCTT-GGC-CAGCGTGAGC-ACCGTGCTGACCTCCAAATACCGTTAA-G-CTGGAGC-CTC---GGC--GA----CCCCT-ACC-C-T-GGCCT----GG----AGC-CC-CCTTGCGC-T-CTGC-GC-A---C-TCT-C-A-CCTCC-----TG-ATCTT-TG-AATAAAGTCTG-AG--TGGGCTGCAG--T-G
>s12
-------------------------------------------C--T---GGACTCCCCTTCGGTCCAGGCCGCGCCCGGGGCTCCGCGCCAGCCAATGAGCGCCG-CGTGTCCGGGCGTGTCCCCGCGC-CCCGAGCATAAACCCTGGCGCGCTGGCCGCCCGGCACTCTTCTGGTC-CACGCAGACTCAGAAAGAACCCACCATGGTGCTGTC-TC-CCGC---CGACAA-GAGCAACGTCAAG-G-C----CGCCTGG-GGTAAGGTCGG-CAGCCAC-GCTG-GC-GACTATGGTGC--CGAGGCCCTGGAGAGGTGAG---GCTC-----------CCT-CCC-CTG-----C------T---CCGA---------CC-----------C--AC--CG-GC----------C--A-CC--CC------C-CA--------CCGGC--CTGG--CCCTGGCGCC--C--G--ACC-CAAACCTCA-CCC-CCT--ACTC-C--GC-CTC--TCT-C-CG-CAGGATGTTC-CTGTCCTTC-CCCACC-ACCAAGACCTACTTC-CCCCAC-TTCGACCTG--AGC-CACGGCTCTGCCCAGGTCAAGGGC--CACGGCAAGAAGGTGGCCGACGC-GC--TCACC---AACGCCGT-G--GCGCA-CGTGGA-CGAC--ATG-CCCAACGCGC-TGT-C-TGCGCTCAGCGACCTGCACGC-GCACAAGCTTCGGGTGGACCCGGTCAACTT-CAA-G-GT--G---AG----TG-GC---CGG------C-AGGA---GC------CAT-----T-TGG--GT--CGAGGGG--C-----GA------G--A---T----CACG--CCT--TCCTC--G---CGGG-GCA--GAGCA--CCCCG-CGGGT----TGC-G-GGA-GGTGTGA--C--------ACAGGCGGC-GGCT-------G---C--------CGGCCCTG-GGCCCCTCT-GA--GCCT----T-GTC-T-CTG--C---ACA-G----CT-CC-T--GAGCC-A--CTGCCTG-C-TGGTGA----CCCTGGC---C-GC--CCACC-AC----CC-G-GCCGA-ATT-C-A--C----CCC--TG-C--GGTG-CAC-G----CC-T----CTCTGGACAAGTTCCT-GGC-TTCTGTGAGC-ACCGTGCTGACCTCCAAATACCGTTAA-G-CTGGAGC-CTCGGTCGC--CAT-TCCTCCTGCCCTC-TGGGCCT--CGGGCCA-GGC-CCTCCTC-CCC-T-CCCT-GC-A-C-C---TGCAACC--CC-TG---G--TCTT-TG-AATAAAGCCTG-AG--TGGGCGGCA------
